2 Qatar - Ecuador
1 England - Iran
2 Senegal - Nederländerna
X USA - Wales
2 Argentina - Saudi Arabien
X Danmark - Tunisien
X Mexiko - Polen
1 Frankrike - Australien
X Marocko - Kroatien
2 Tyskland - Japan
1 Spanien - Costa Rica
1 Belgien - Kanada
1 Schweiz - Kamerun
X Uruguay - Korea
1 Portugal - Ghana
1 Brasilien - Serbien
2 Wales - Iran
2 Qatar - Senegal
X Nederländerna - Ecuador
X England - USA
2 Tunisien - Australien
1 Polen - Saudi Arabien
1 Frankrike - Danmark
1 Argentina - Mexiko
Japan - Costa Rica
Belgien - Marocko
Kroatien - Kanada
Spanien - Tyskland
Kamerun - Serbien
Syd Korea - Ghana
Brasilien - Schweiz
Portugal - Uruguay
Nederländerna - Qatar
Ecuador - Senegal
Wales - England
Iran - USA
Australien - Danmark
Tunisien - Frankrike
Polen - Argentina
Saudi Arabien - Mexiko
Kroatien - Belgien
Kanada - Marocko
Costa Rica - Tyskland
Japan - Spanien
Sydkorea - Portugal
Ghana - Uruguay
Serbien - Schweiz
Kamerun - Brasilien
